##########
#S.......#
####.#####
#.....#..#
#.....#..#
#.#####..#
#........#
#..###.###
#.......H#
##########
