10 20
####################
#S#...#...#...#...##
#...#...#...#...#..#
#.#...#...#...#...##
#...#...#...#...#..#
#.#...#...#...#...##
#...#...#...#...#..#
#.#...#...#...#...##
#...#...#...#...#.H#
####################
