10 10
##########
#S.......#
#........#
#........#
########.#
#........#
#........#
#........#
#.......H#
##########
